Adrenal_Gland	Adrenal_Gland.146samples.covariate.sorted.txt
Bladder	Bladder.9samples.covariate.sorted.txt
Blood	Blood.356samples.covariate.sorted.txt
Blood_Vessel	Blood_Vessel.378samples.covariate.sorted.txt
Brain	Brain.170samples.covariate.sorted.txt
Breast	Breast.184samples.covariate.sorted.txt
Cervix_Uteri	Cervix_Uteri.8samples.covariate.sorted.txt
Colon	Colon.250samples.covariate.sorted.txt
Esophagus	Esophagus.353samples.covariate.sorted.txt
Fallopian_Tube	Fallopian_Tube.7samples.covariate.sorted.txt
Heart	Heart.251samples.covariate.sorted.txt
Kidney	Kidney.29samples.covariate.sorted.txt
Liver	Liver.118samples.covariate.sorted.txt
Lung	Lung.274samples.covariate.sorted.txt
Muscle	Muscle.359samples.covariate.sorted.txt
Nerve	Nerve.268samples.covariate.sorted.txt
Ovary	Ovary.99samples.covariate.sorted.txt
Pancreas	Pancreas.167samples.covariate.sorted.txt
Pituitary	Pituitary.108samples.covariate.sorted.txt
Prostate	Prostate.101samples.covariate.sorted.txt
Salivary_Gland	Salivary_Gland.63samples.covariate.sorted.txt
Skin	Skin.442samples.covariate.sorted.txt
Small_Intestine	Small_Intestine.90samples.covariate.sorted.txt
Spleen	Spleen.108samples.covariate.sorted.txt
Stomach	Stomach.182samples.covariate.sorted.txt
Testis	Testis.171samples.covariate.sorted.txt
Thyroid	Thyroid.286samples.covariate.sorted.txt
Uterus	Uterus.82samples.covariate.sorted.txt
Vagina	Vagina.87samples.covariate.sorted.txt
